{
  "map": [
    [7, 8, 9, 10, 0, 0, 0, 0, 0, 8],
    [0, 0, 0, 0, 0, 1, 1, 1, 1, 1],
    [1, 1, 2, 3, 0, 1, 1, 1, 1, 1],
    [1, 3, 0, 3, 0, 1, 1, 1, 1, 1],
    [1, 3, 2, 0, 0, 1, 1, 1, 1, 1],
    [7, 8, 9, 10, 0, 0, 0, 0, 0, 8],
    [0, 0, 0, 0, 0, 1, 1, 1, 1, 1],
    [1, 1, 2, 3, 0, 8, 1, 1, 1, 1],
    [1, 3, 0, 3, 0, 1, 1, 1, 1, 1],
    [1, 3, 2, 0, 0, 1, 1, 1, 1, 1],
    [7, 8, 9, 10, 0, 12, 0, 0, 0, 8],
    [0, 0, 0, 0, 0, 1, 1, 1, 1, 1],
    [1, 1, 2, 3, 0, 1, 1, 1, 1, 1],
    [1, 5, 0, 3, 0, 1, 1, 1, 1, 1],
    [1, 5, 5, 5, 5, 1, 1, 1, 1, 1],
    [7, 5, 5, 5, 5, 0, 0, 0, 0, 8],
    [4, 4, 4, 0, 5, 1, 1, 1, 1, 1],
    [8, 9, 10, 11, 0, 1, 1, 1, 1, 1],
    [12, 13, 14, 15, 0, 1, 1, 1, 1, 1],
    [12, 5, 5, 0, 0, 1, 1, 1, 1, 1]
  ],
  "events": {
    "5": { "enemy": "TopDown", "number": 5 },
    "10": { "enemy": "LeftRight", "number": 5 },
    "15": { "enemy": "TopDown", "number": 10 },
    "20": { "enemy": "LeftRight", "number": 5 },
    "21": { "enemy": "TopDown", "number": 5 },
    "30": { "enemy": "LeftRight", "number": 15 },
    "35": { "enemy": "TopDown", "number": 20 },
    "40": { "enemy": "LeftRight", "number": 30 }
  }
}
